Width 30
Height 20
1  7  7  7  7  7  7  7  7  7  7  7  7  7  7  7  7  7  7  7  7  7  7  7  7  7  7  7  7  2 
5  0  13 0  0  0  0  0  0  0  0  0  0  0  0  0  0  0  0  0  0  0  0  0  0  0  0  0  13 6 
5  0  13 0  0  0  0  0  0  0  0  0  0  0  0  0  0  0  0  0  0  0  0  0  0  0  0  0  13 6 
5  0  13 0  0  0  0  0  0  0  0  0  0  0  0  0  0  0  0  0  0  0  0  0  0  0  0  0  13 6 
5  0  13 0  0  0  0  0  0  0  0  0  0  0  0  0  0  0  0  0  0  0  0  0  0  0  0  0  13 6 
5  0  13 0  0  0  0  0  0  0  0  0  0  0  0  0  0  0  0  0  0  0  0  0  0  0  0  0  13 6 
5  0  11 14 14 14 14 14 14 14 14 14 14 14 14 13 14 14 14 14 14 14 14 14 14 14 14 14 12 6 
5  0  0  0  0  0  0  0  0  0  0  0  0  0  0  13 0  0  0  0  0  0  0  0  0  0  0  0  0  6 
5  0  0  0  0  0  0  0  0  0  0  0  0  0  0  13 0  0  0  0  0  0  0  0  0  0  0  0  0  6 
5  0  0  0  0  0  0  0  0  0  0  0  0  0  0  13 0  0  0  0  0  0  0  0  0  0  0  0  0  6 
5  0  0  0  0  0  0  0  0  0  0  0  0  0  0  13 0  0  0  0  0  0  0  0  0  0  0  0  0  6 
5  0  0  0  0  0  0  0  0  0  0  0  0  0  0  13 0  0  0  0  0  0  0  0  0  0  0  0  0  6 
5  0  0  0  0  0  0  0  0  0  0  0  0  0  0  13 0  0  0  0  0  0  0  0  0  0  0  0  0  6 
5  0  0  0  0  0  0  0  0  0  0  0  0  0  0  11 14 14 14 14 14 14 14 14 14 10 0  0  0  6 
5  0  0  0  0  0  0  0  0  0  0  0  0  0  0  0  0  0  0  0  0  0  0  0  0  13 0  0  0  6 
5  0  0  0  0  0  0  0  0  0  0  0  0  0  0  0  0  0  0  0  0  0  0  0  0  13 0  0  0  6 
5  0  0  0  0  13 0  0  0  0  0  0  0  0  0  0  0  0  0  0  0  0  0  0  0  13 0  0  0  6 
5  0  0  0  0  13 0  0  0  0  0  0  0  0  0  0  0  0  0  0  0  0  0  0  0  13 0  0  0  6 
5  0  0  0  0  11 14 14 14 14 14 14 14 14 14 14 14 14 14 14 14 14 14 14 14 12 0  0  0  6 
3  8  8  8  8  8  8  8  8  8  8  8  8  8  8  8  8  8  8  8  8  8  8  8  8  8  8  8  8  4  
